Grimes	Oblivion
Alvvays	Dreams Tonite
Phoebe Bridgers	Motion Sickness
Big Thief	Masterpiece
Wolf Alice	Donâ€™t Delete The Kisses
Courtney Barnett	Avant Gardener
Declan McKenna	Brazil
HAIM	Summer Girl - Bonus Track
Grimes	Oblivion
Alvvays	Archie, Marry Me
Bombay Bicycle Club	Eat, Sleep, Wake (Nothing But You) - Single Version
Future Islands	Seasons (Waiting On You)
Sylvan Esso	Funeral Singers
Broken Bells	Shelter
Spoon	Inside Out
Tame Impala	Feels Like We Only Go Backwards
Local Natives	When Am I Gonna Lose You
Clairo	Bags
Wolf Alice	Bros
Delicate Steve	Positive Force
LCD Soundsystem	oh baby
The War On Drugs	Red Eyes
The Big Moon	Your Light
Japanese Breakfast	Road Head
Tame Impala	Eventually
Whitney	Valleys (My Love)
LCD Soundsystem	I Can Change
Sufjan Stevens	Should Have Known Better
Bakar	Hell N Back
Sharon Van Etten	Every Time the Sun Comes Up
Flyte	Victoria Falls
Tame Impala	Let It Happen
Lucy Dacus	Night Shift
Local Natives	Dark Days
Beach House	Lemon Glow
Sharon Van Etten	Seventeen
Bombay Bicycle Club	Always Like This
Rostam	In a River
Faye Webster	Kingston
Angel Olsen	Shut Up Kiss Me
Kurt Vile	Wakin on a Pretty Day
Unknown Mortal Orchestra	Necessary Evil
Tame Impala	Borderline
Gengahr	She's a Witch
Vampire Weekend	Step
Maggie Rogers	Alaska
Everything Everything	No Reptiles
Father John Misty	Chateau Lobby #4 (in C for Two Virgins)
Arlo Parks	Super Sad Generation
NilÃ¼fer Yanya	Baby Blu
